111111111111111111111
1CY000CCCC000000000C1
1000101000000001CY011
1P001E100Y00000CCCC01
111111111111111111111
