1111111
1C000P1
1000001
1P000E1
1111111