1111111
1C00001
100F001
1P000E1
1111111