1111111
1C10001
110C001
1P000E1
1111111