1111111
1C00001
100P001
10000E1
1111111